NO ./path_to_the_north_texture
SO ./path_to_the_north_texture                  
WE ./path_to_the_west_texture
EA ./path_to_the_west_texture




F       20,   3  ,0
C       255, 0, 0

        1111
111110100101010100101100101
1111100100100000000000000000000101001
1000000  0 00 0 0 0 0000001  11110010010
10110100101010101011001010101001010101
011101010101010010101010100101010101001010101001
       111111







       