NO ./path_to_the_north_texture
SO ./path_to_the_north_texture                  
WE ./path_to_the_west_texture
EA ./path_to_the_west_texture




F       20,   3  ,0
C       255, 30, 0

        1111



    