NO ./path_to_the_north_texture
SO ./path_to_the_north_texture                  
WE ./path_to_the_west_texture
EA ./path_to_the_west_texture                  

F       20, 0,0
C       255, 0, 0

11111111111111
10000010001001
11101010101101
10001000001001
10101110111101
10101S10100001
10000010100001
11111111111111