                           
SO ./assets/so.xpm
EA ./assets/ea.xpm
WE ./assets/we.xpm
NO ./assets/no.xpm

F 32,32,32
C 0,25,51

111111111111111111111111
111111111111111111111111
111111111111111111111111
111111111000010000E00011
111111111111111111111111