   SO ./path_to_the_north_texture
EA ./path_to_the_south_texture
WE ./path_to_the_west_textures
NO ./path_to_the_east_texture  

F 200,255,0
C 203,103,0

1111111111111111111111111                 
1000000001000000000000111
1011000001110000000000001              
1111111111111111111111111
1111111111111111111111111
1001000000000E00000000001
1111111110110000011100001
1100000000011000011101111
1111101111110110111010001
1111111111111111111111111